{
  "width": 25,
  "height": 19,
  "tileSize": 32,
  "layers": [
    {
      "name": "ground",
      "data": [
        "G", "G", "G", "G", "G", "G", "G", "G", "G", "G", "G", "G", "G", "G", "G", "G", "G", "G", "G", "G", "G", "G", "G", "G", "G",
        "G", "G", "G", "G", "G", "G", "G", "G", "G", "G", "G", "G", "G", "G", "G", "G", "G", "G", "G", "G", "G", "G", "G", "G", "G",
        "G", "G", "G", "G", "G", "G", "G", "G", "G", "G", "G", "G", "G", "G", "G", "G", "G", "G", "G", "G", "G", "G", "G", "G", "G",
        "G", "G", "W", "W", "W", "W", "W", "W", "W", "W", "W", "W", "W", "W", "W", "W", "W", "W", "W", "W", "G", "G", "G", "G", "G",
        "G", "G", "W", "G", "G", "G", "G", "G", "G", "G", "G", "G", "G", "G", "G", "G", "G", "G", "G", "G", "G", "G", "G", "G", "G",
        "G", "G", "W", "G", "G", "G", "G", "G", "G", "G", "G", "G", "G", "G", "G", "G", "G", "G", "G", "G", "G", "G", "G", "G", "G",
        "G", "G", "W", "G", "D", "D", "D", "D", "D", "G", "G", "D", "D", "D", "D", "D", "G", "G", "D", "D", "D", "D", "D", "G", "G",
        "G", "G", "W", "G", "D", "D", "D", "D", "D", "G", "G", "D", "D", "D", "D", "D", "G", "G", "D", "D", "D", "D", "D", "G", "G",
        "G", "G", "W", "G", "D", "D", "D", "D", "D", "G", "G", "D", "D", "D", "D", "D", "G", "G", "D", "D", "D", "D", "D", "G", "G",
        "G", "G", "W", "G", "G", "G", "G", "G", "G", "G", "G", "G", "G", "G", "G", "G", "G", "G", "G", "G", "G", "G", "G", "G", "G",
        "G", "G", "W", "G", "G", "G", "G", "G", "G", "G", "G", "G", "G", "G", "G", "G", "G", "G", "G", "G", "G", "G", "G", "G", "G",
        "G", "G", "W", "G", "G", "G", "G", "G", "G", "G", "G", "G", "G", "G", "G", "G", "G", "G", "G", "G", "G", "G", "G", "G", "G",
        "G", "G", "G", "G", "G", "G", "G", "G", "G", "G", "G", "G", "G", "G", "G", "G", "G", "G", "G", "G", "G", "G", "G", "G", "G",
        "G", "G", "G", "G", "G", "G", "G", "G", "G", "G", "G", "G", "G", "G", "G", "G", "G", "G", "G", "G", "G", "G", "G", "G", "G",
        "G", "G", "G", "G", "G", "G", "G", "G", "G", "G", "G", "G", "G", "G", "G", "G", "G", "G", "G", "G", "G", "G", "G", "G", "G",
        "G", "G", "G", "G", "G", "G", "G", "G", "G", "G", "G", "G", "G", "G", "G", "G", "G", "G", "G", "G", "G", "G", "G", "G", "G",
        "G", "G", "G", "G", "G", "G", "G", "G", "G", "G", "G", "G", "G", "G", "G", "G", "G", "G", "G", "G", "G", "G", "G", "G", "G",
        "G", "G", "G", "G", "G", "G", "G", "G", "G", "G", "G", "G", "G", "G", "G", "G", "G", "G", "G", "G", "G", "G", "G", "G", "G",
        "G", "G", "G", "G", "G", "G", "G", "G", "G", "G", "G", "G", "G", "G", "G", "G", "G", "G", "G", "G", "G", "G", "G", "G", "G"
      ]
    }
  ],
  "tilesets": [
    {
      "name": "farm_tileset",
      "firstgid": 1,
      "image": "assets/tilesets/main_tileset.png",
      "tilewidth": 32,
      "tileheight": 32,
      "tiles": {
        "G": {
          "id": 0,
          "type": "grass"
        },
        "D": {
          "id": 1,
          "type": "dirt"
        },
        "W": {
          "id": 2,
          "type": "water"
        }
      }
    }
  ]
        }
